25 21 Woodland Large
10 20 00 00 00 20 00 20 00 00 40 00 00 00 40 00 00 20 00 20 00 00 00 20 10
20 20 00 00 00 00 20 00 00 00 00 20 10 20 00 00 00 00 20 00 00 00 00 20 20
00 00 00 00 00 20 00 20 00 00 00 20 20 20 00 00 00 20 00 20 00 00 00 00 00
10 00 40 00 00 00 00 00 00 00 40 00 00 00 40 00 00 00 00 00 00 00 40 00 10
00 20 00 00 00 20 00 20 00 00 00 00 00 00 00 00 00 20 00 20 00 00 00 20 00
40 00 40 00 00 00 20 00 00 00 00 00 00 00 00 00 00 00 20 00 00 00 40 00 40
00 00 00 00 00 20 00 20 00 00 00 10 10 10 00 00 00 20 00 20 00 00 00 00 00
20 00 00 00 00 00 00 00 00 00 00 00 00 00 00 00 00 00 00 00 00 00 00 00 20
50 20 00 00 40 00 00 00 00 00 00 20 20 20 00 00 00 00 00 00 40 00 00 20 60
50 50 20 00 00 40 00 20 00 00 00 20 10 20 00 00 00 20 00 40 00 00 20 60 60
50 50 50 20 00 00 10 00 00 00 00 20 10 20 00 00 00 00 10 00 00 20 60 60 60
50 50 20 00 00 40 00 20 00 00 00 20 10 20 00 00 00 20 00 40 00 00 20 60 60
50 20 00 00 40 00 00 00 00 00 00 20 20 20 00 00 00 00 00 00 40 00 00 20 60
20 00 00 00 00 00 00 00 00 00 00 00 00 00 00 00 00 00 00 00 00 00 00 00 20
00 00 00 00 00 20 00 20 00 00 00 10 10 10 00 00 00 20 00 20 00 00 00 00 00
40 00 40 00 00 00 20 00 00 00 00 00 00 00 00 00 00 00 20 00 00 00 40 00 40
00 20 00 00 00 20 00 20 00 00 00 00 00 00 00 00 00 20 00 20 00 00 00 20 00
10 00 40 00 00 00 00 00 00 00 40 00 00 00 40 00 00 00 00 00 00 00 40 00 10
00 00 00 00 00 20 00 20 00 00 00 20 20 20 00 00 00 20 00 20 00 00 00 00 00
20 20 00 00 00 00 20 00 00 00 00 20 10 20 00 00 00 00 20 00 00 00 00 20 20
10 20 00 00 00 20 00 20 00 00 40 00 00 00 40 00 00 20 00 20 00 00 00 20 10
Default Map.