29 6 Woodland Tiny
60 20 20 40 40 40 40 40 40 40 40 40 40 40 40 40 40 40 40 40 40 40 40 40 40 40 20 20 50
60 20 20 00 00 00 00 10 10 10 10 10 10 10 10 10 10 10 10 10 10 10 00 00 00 00 20 20 50
60 20 20 00 00 00 00 00 00 00 00 00 00 00 00 00 00 00 00 00 00 00 00 00 00 00 20 20 50
60 20 20 00 00 00 00 00 00 00 00 00 00 00 00 00 00 00 00 00 00 00 00 00 00 00 20 20 50
60 20 20 00 00 00 00 10 10 10 10 10 10 10 10 10 10 10 10 10 10 10 00 00 00 00 20 20 50
60 20 20 40 40 40 40 40 40 40 40 40 40 40 40 40 40 40 40 40 40 40 40 40 40 40 20 20 50
Into the valley of Death rode the six hundred.