15 15 woodland small
00 20 20 20 00 00 20 00 00 00 00 20 20 20 00
20 00 20 20 20 20 00 00 00 20 00 20 20 00 00
00 00 20 20 00 00 00 00 00 20 20 20 20 00 20
20 00 20 20 00 20 00 10 00 00 00 20 20 40 40
00 20 20 20 00 00 00 10 00 00 00 00 20 40 40
00 20 20 20 00 00 00 40 00 00 00 20 20 00 00
00 00 20 20 50 50 00 40 00 60 60 20 20 20 00
00 00 20 20 50 50 00 40 00 60 60 20 20 00 00
20 20 20 20 50 50 00 40 00 60 60 20 20 20 20
00 00 20 20 00 00 00 40 00 00 00 20 20 00 00
00 00 20 20 00 00 00 10 00 00 00 20 20 00 00
20 20 20 20 20 00 00 10 00 00 20 20 20 20 20
20 20 20 20 00 20 00 00 20 00 20 20 20 20 00
00 40 20 20 20 00 00 00 00 00 00 20 20 00 00
00 00 20 20 00 00 00 00 00 00 00 20 20 00 20