15 15 Woodland Small
40 20 20 20 20 20 20 00 20 20 20 20 20 20 40
20 20 20 20 20 20 00 00 00 20 20 20 20 20 20
20 20 00 00 00 00 00 00 00 00 00 00 00 20 20
20 20 00 00 00 00 00 10 00 00 00 00 00 20 20
20 20 00 00 00 00 00 10 00 00 00 00 00 20 20
00 20 20 20 00 00 00 40 00 00 00 20 20 20 00
00 00 20 50 50 00 00 40 00 00 60 60 20 00 00
10 10 00 50 50 00 00 40 00 00 60 60 00 10 10
00 00 20 50 50 00 00 40 00 00 60 60 20 00 00
00 20 20 20 00 00 00 40 00 00 00 20 20 20 00
20 20 00 00 00 00 00 10 00 00 00 00 00 20 20
20 20 00 00 00 00 00 10 00 00 00 00 00 20 20
20 20 00 00 00 00 00 00 00 00 00 00 00 20 20
20 20 20 20 20 20 00 00 00 20 20 20 20 20 20
40 20 20 20 20 20 20 00 20 20 20 20 20 20 40
Get ready to fight right off the bat as there isn't much breathing room between you and your opponent.