15 15 woodland small
60 60 60 20 20 20 20 20 20 20 20 20 50 50 50
60 60 20 20 20 20 20 20 20 20 20 20 20 50 50
60 20 20 20 20 20 20 20 20 20 20 20 20 20 50
20 20 20 20 20 20 20 20 20 20 20 20 20 20 20
20 20 20 20 20 20 20 20 20 20 20 20 20 20 20
20 20 20 20 20 20 20 20 20 20 20 20 20 20 20
20 20 20 20 20 20 20 20 20 20 20 20 20 20 20
20 20 20 20 20 20 20 20 20 20 20 20 20 20 20
20 20 20 20 20 20 20 20 20 20 20 20 20 20 20
20 20 20 20 20 20 20 20 20 20 20 20 20 20 20
20 20 20 20 20 20 20 20 20 20 20 20 20 20 20
20 20 20 20 20 20 20 20 20 20 20 20 20 20 20
50 20 20 20 20 20 20 20 20 20 20 20 20 20 60
50 50 20 20 20 20 20 20 20 20 20 20 20 60 60
50 50 50 20 20 20 20 20 20 20 20 20 60 60 60