15 15 woodland small
50 50 50 20 20 20 20 20 20 20 20 20 60 60 60
50 50 20 20 20 20 20 20 20 20 20 20 20 60 60
50 20 20 20 20 20 20 20 20 20 20 20 20 20 60
20 20 20 20 20 20 20 20 20 20 20 20 20 20 20
20 20 20 20 20 20 20 20 20 20 20 20 20 20 20
20 20 20 20 20 20 20 20 20 20 20 20 20 20 20
20 20 20 20 20 20 20 20 20 20 20 20 20 20 20
20 20 20 20 20 20 20 20 20 20 20 20 20 20 20
20 20 20 20 20 20 20 20 20 20 20 20 20 20 20
20 20 20 20 20 20 20 20 20 20 20 20 20 20 20
20 20 20 20 20 20 20 20 20 20 20 20 20 20 20
20 20 20 20 20 20 20 20 20 20 20 20 20 20 20
50 20 20 20 20 20 20 20 20 20 20 20 20 20 60
50 50 20 20 20 20 20 20 20 20 20 20 20 60 60
50 50 50 20 20 20 20 20 20 20 20 20 60 60 60