20 15 Woodland Medium
50 50 50 20 20 00 00 00 20 20 20 20 00 00 00 40 00 00 00 40
50 50 20 20 00 00 00 00 20 20 20 20 00 00 00 00 20 20 20 00
50 20 20 00 00 00 00 10 00 00 00 00 10 00 00 00 20 20 20 00
20 20 00 00 00 00 00 00 00 00 00 00 00 00 00 00 20 20 20 00
20 00 00 00 40 00 40 00 00 00 00 00 00 00 00 40 00 00 00 40
00 00 00 00 00 40 00 00 00 00 00 00 00 00 00 00 00 00 00 00
00 00 00 00 00 00 00 00 10 00 00 00 00 00 00 00 20 20 00 00
00 00 10 20 00 00 00 10 00 40 40 00 10 00 00 00 20 10 00 00
00 00 20 20 00 00 00 00 00 00 00 10 00 00 00 00 00 00 00 00
00 00 00 00 00 00 00 00 00 00 00 00 00 00 40 00 00 00 00 00
40 00 00 00 40 00 00 00 00 00 00 00 00 40 00 40 00 00 00 20
00 20 20 20 00 00 00 00 00 00 00 00 00 00 00 00 00 00 20 20
00 20 20 20 00 00 00 10 00 00 00 00 10 00 00 00 00 20 20 60
00 20 20 20 00 00 00 00 20 20 20 20 00 00 00 00 20 20 60 60
40 00 00 00 40 00 00 00 20 20 20 20 00 00 00 20 20 60 60 60
Found you! Killed you!