15 15 Woodland Small
20 20 20 20 20 20 20 20 20 20 20 20 20 20 20
20 20 20 20 20 20 20 10 20 20 20 20 20 20 20
20 20 20 20 20 00 40 10 40 00 20 20 20 20 20
20 20 20 20 00 00 00 10 00 00 00 20 20 20 20
20 20 20 00 00 00 40 10 40 00 00 00 20 20 20
20 20 00 00 00 00 00 10 00 00 00 00 00 20 20
20 00 00 00 00 00 40 10 40 00 00 00 00 00 20
00 00 00 00 00 00 00 10 00 00 00 00 00 00 00
00 00 00 00 00 00 40 10 40 00 00 00 00 00 00
00 00 00 00 00 00 00 10 00 00 00 00 00 00 00
00 00 00 00 00 00 40 10 40 00 00 00 00 00 00
20 20 20 20 00 00 00 10 00 00 00 20 20 20 20
50 50 50 20 00 00 40 10 40 00 00 20 60 60 60
50 50 50 20 00 00 00 10 00 00 00 20 60 60 60
50 50 50 20 00 00 40 10 40 00 00 20 60 60 60
So long, much travese, wow.  Don't get caught at the chokepoint at the end or suffer the consequences