21 15 Woodland Medium
00 00 00 00 00 00 00 00 00 00 00 00 00 00 00 00 40 20 20 20 20
00 00 00 40 00 10 00 00 40 40 00 10 00 00 10 00 00 60 60 60 20
00 00 10 00 00 00 00 00 00 40 00 00 00 00 00 00 00 60 60 60 20
00 00 00 00 00 00 00 00 00 00 00 00 00 00 00 00 00 00 00 00 40
00 00 20 20 20 20 00 00 00 00 00 00 00 40 40 00 00 20 20 00 00
00 00 20 20 20 20 00 00 00 00 00 00 00 40 00 00 00 20 20 00 00
00 00 00 00 00 00 00 00 00 00 20 00 00 00 00 00 00 00 00 00 00
00 00 00 00 00 00 00 00 00 20 20 20 00 00 00 00 00 00 00 00 00
00 00 00 00 00 00 00 00 00 00 20 00 00 00 00 00 00 00 00 00 00
00 00 20 20 00 00 00 40 00 00 00 00 00 00 00 20 20 20 20 00 00
00 00 20 20 00 00 40 40 00 00 00 00 00 00 00 20 20 20 20 00 00
40 00 00 00 00 00 00 00 00 00 00 00 00 00 00 00 00 00 00 00 00
20 50 50 50 00 00 00 00 00 00 00 40 00 00 00 00 00 00 10 00 00
20 50 50 50 00 00 10 00 00 10 00 40 40 00 00 10 00 40 00 00 00
20 20 20 20 40 00 00 00 00 00 00 00 00 00 00 00 00 00 00 00 00
Run from cover to cover and kill before you get spotted.