20 20 Woodland Medium
20 20 20 20 20 20 20 20 20 20 20 20 20 20 20 20 20 20 20 20
20 20 20 20 20 20 20 60 60 60 60 60 60 20 20 20 20 20 20 20
00 00 00 00 00 00 00 00 00 00 00 00 00 00 00 00 00 00 00 00
00 00 00 00 00 00 00 00 00 00 00 00 00 00 00 00 00 00 00 00
10 10 10 10 00 00 10 10 10 10 10 10 10 10 00 00 10 10 10 10
00 00 00 00 00 00 00 00 00 00 00 00 00 00 00 00 00 00 00 00
40 40 40 00 00 00 00 40 40 40 40 40 40 00 00 00 00 40 40 40
00 00 00 00 00 00 00 00 00 00 00 00 00 00 00 00 00 00 00 00
00 10 10 10 10 10 10 10 00 00 00 00 10 10 10 10 10 10 10 00
00 00 00 00 00 00 00 00 00 40 40 00 00 00 00 00 00 00 00 00
00 00 00 00 00 00 00 00 00 40 40 00 00 00 00 00 00 00 00 00
00 10 10 10 10 10 10 10 00 00 00 00 10 10 10 10 10 10 10 00
00 00 00 00 00 00 00 00 00 00 00 00 00 00 00 00 00 00 00 00
40 40 40 00 00 00 00 40 40 40 40 40 40 00 00 00 00 40 40 40
00 00 00 00 00 00 00 00 00 00 00 00 00 00 00 00 00 00 00 00
10 10 10 10 00 00 10 10 10 10 10 10 10 10 00 00 10 10 10 10
00 00 00 00 00 00 00 00 00 00 00 00 00 00 00 00 00 00 00 00
00 00 00 00 00 00 00 00 00 00 00 00 00 00 00 00 00 00 00 00
20 20 20 20 20 20 20 50 50 50 50 50 50 20 20 20 20 20 20 20
20 20 20 20 20 20 20 20 20 20 20 20 20 20 20 20 20 20 20 20
Who will venture out into the kill zone first?