20 20 woodland medium
20 20 20 20 20 20 20 20 20 20 20 20 20 20 20 20 20 20 20 20
20 20 20 20 20 20 20 20 20 20 20 20 20 20 20 20 20 20 20 20
20 20 20 20 20 20 20 20 20 20 20 20 20 20 20 20 20 20 20 20
20 20 20 20 20 20 20 60 60 60 60 60 60 20 20 20 20 20 20 20
00 00 00 00 00 00 00 00 00 00 00 00 00 00 00 00 00 00 00 00
00 00 00 00 00 00 00 00 00 00 00 00 00 00 00 00 00 40 00 00
00 00 00 00 00 00 00 00 00 00 40 00 00 00 00 10 00 00 00 00
00 00 00 10 00 00 00 40 00 00 00 10 10 00 00 00 00 00 00 00
00 10 10 00 00 00 00 10 00 10 00 00 00 10 00 00 10 00 00 10
00 00 10 00 00 10 10 40 00 10 00 00 00 00 00 10 00 00 00 10
00 00 40 00 00 00 00 00 00 00 00 10 40 00 00 10 00 10 10 00
40 00 00 00 00 00 00 00 10 40 00 00 00 00 00 00 00 00 00 00
00 00 00 00 00 00 00 00 00 00 00 00 00 00 00 00 00 00 40 40
00 00 00 40 00 00 00 00 40 00 00 00 00 40 00 00 00 00 00 00
00 00 00 00 00 00 00 00 00 00 00 00 00 00 00 00 00 00 00 00
00 00 00 00 00 00 00 00 00 00 00 00 00 00 00 00 00 40 00 00
20 20 20 20 20 20 20 50 50 50 50 50 50 20 20 20 20 20 20 20
20 20 20 20 20 20 20 20 20 20 20 20 20 20 20 20 20 20 20 20
20 20 20 20 20 20 20 20 20 20 20 20 20 20 20 20 20 20 20 20
20 20 20 20 20 20 20 20 20 20 20 20 20 20 20 20 20 20 20 20