25 25 Woodland Large
40 00 00 00 40 00 00 00 40 00 00 00 40 00 00 00 40 00 00 00 40 00 00 00 40
00 20 20 20 00 20 20 20 00 20 20 20 00 20 20 20 00 20 20 20 00 20 20 20 00
00 20 50 20 00 20 60 20 00 20 50 20 00 20 60 20 00 20 50 20 00 20 60 20 00
00 20 20 20 00 20 20 20 00 20 20 20 00 20 20 20 00 20 20 20 00 20 20 20 00
40 00 00 00 10 00 00 00 10 00 00 00 10 00 00 00 10 00 00 00 10 00 00 00 40
00 20 20 20 00 20 20 20 00 20 20 20 00 20 20 20 00 20 20 20 00 20 20 20 00
00 20 60 20 00 20 50 20 00 20 60 20 00 20 50 20 00 20 60 20 00 20 50 20 00
00 20 20 20 00 20 20 20 00 20 20 20 00 20 20 20 00 20 20 20 00 20 20 20 00
40 00 00 00 10 00 00 00 10 00 00 00 10 00 00 00 10 00 00 00 10 00 00 00 40
00 20 20 20 00 20 20 20 00 20 20 20 00 20 20 20 00 20 20 20 00 20 20 20 00
00 20 50 20 00 20 60 20 00 20 50 20 00 20 60 20 00 20 50 20 00 20 60 20 00
00 20 20 20 00 20 20 20 00 20 20 20 00 20 20 20 00 20 20 20 00 20 20 20 00
40 00 00 00 10 00 00 00 10 00 00 00 10 00 00 00 10 00 00 00 10 00 00 00 40
00 20 20 20 00 20 20 20 00 20 20 20 00 20 20 20 00 20 20 20 00 20 20 20 00
00 20 60 20 00 20 50 20 00 20 60 20 00 20 50 20 00 20 60 20 00 20 50 20 00
00 20 20 20 00 20 20 20 00 20 20 20 00 20 20 20 00 20 20 20 00 20 20 20 00
40 00 00 00 10 00 00 00 10 00 00 00 10 00 00 00 10 00 00 00 10 00 00 00 40
00 20 20 20 00 20 20 20 00 20 20 20 00 20 20 20 00 20 20 20 00 20 20 20 00
00 20 50 20 00 20 60 20 00 20 50 20 00 20 60 20 00 20 50 20 00 20 60 20 00
00 20 20 20 00 20 20 20 00 20 20 20 00 20 20 20 00 20 20 20 00 20 20 20 00
40 00 00 00 10 00 00 00 10 00 00 00 10 00 00 00 10 00 00 00 10 00 00 00 40
00 20 20 20 00 20 20 20 00 20 20 20 00 20 20 20 00 20 20 20 00 20 20 20 00
00 20 60 20 00 20 50 20 00 20 60 20 00 20 50 20 00 20 60 20 00 20 50 20 00
00 20 20 20 00 20 20 20 00 20 20 20 00 20 20 20 00 20 20 20 00 20 20 20 00
40 00 00 00 40 00 00 00 40 00 00 00 40 00 00 00 40 00 00 00 40 00 00 00 40
The Colonial Marines scattered and without air support, chose to eat bacon for breakfast.