20 20 woodland medium
20 20 20 00 00 00 00 00 00 20 20 20 00 00 00 00 00 20 20 20
20 50 20 00 00 00 00 00 00 20 50 20 00 40 00 00 00 20 50 20
20 20 20 00 40 40 00 00 00 20 20 20 00 00 00 00 00 20 20 20
00 00 00 00 20 20 20 00 00 00 00 00 00 20 20 20 00 00 00 00
00 00 00 00 20 60 20 00 00 00 00 00 00 20 60 20 00 40 10 00
20 20 20 00 20 20 20 00 00 00 00 00 00 20 20 20 00 10 00 00
20 60 20 00 00 00 00 00 00 20 20 20 00 00 00 00 00 00 00 00
20 20 20 00 00 40 10 00 00 20 50 20 00 20 20 20 00 00 00 00
00 00 00 00 00 00 00 00 00 20 20 20 00 20 60 20 00 20 20 20
10 00 00 00 40 00 00 10 00 00 00 00 00 20 20 20 00 20 50 20
10 00 00 00 40 00 10 00 00 00 00 00 00 00 00 00 00 20 20 20
00 00 00 00 00 00 00 00 00 00 00 20 20 20 00 00 00 00 00 00
00 20 20 20 00 00 20 20 20 00 00 20 50 20 00 10 00 00 00 00
00 20 50 20 00 00 20 60 20 00 00 20 20 20 00 10 00 00 40 00
00 20 20 20 00 00 20 20 20 00 10 00 00 00 00 10 00 00 00 00
00 00 00 00 20 20 20 00 00 00 00 00 00 00 00 00 00 00 00 00
00 00 00 00 20 60 20 00 00 00 20 20 0 00 00 00 00 00 00 00
20 20 20 00 20 20 20 00 00 00 20 50 20 40 00 00 00 20 20 20
20 60 20 00 00 00 00 00 00 00 20 20 20 00 00 00 00 20 60 20
20 20 20 00 40 00 00 00 00 00 00 00 00 00 00 00 00 20 20 20