20 20 woodland medium
00 00 00 00 00 00 00 00 10 10 10 10 00 00 00 00 00 00 00 00
00 00 00 00 00 00 00 00 10 60 60 10 00 00 00 00 00 00 00 00
00 00 00 00 00 00 00 00 00 00 00 00 00 00 00 00 00 00 00 00
00 00 00 00 00 00 00 00 00 00 00 00 00 00 00 00 00 00 00 00
00 00 00 00 00 00 00 00 00 00 00 00 00 00 00 00 00 00 00 00
00 00 00 00 00 00 00 00 20 20 20 20 00 00 00 00 00 00 00 00
00 00 00 00 00 00 00 20 20 20 20 20 20 00 00 00 00 00 00 00
10 10 00 00 00 00 20 20 20 00 00 20 20 20 00 00 00 00 10 10
10 60 00 00 00 20 20 20 00 50 50 00 20 20 00 00 00 00 60 10
10 60 00 00 00 20 20 00 50 50 50 50 00 20 20 00 00 00 60 10
10 10 00 00 00 20 20 20 00 50 50 00 20 20 20 00 00 00 10 10
00 00 00 00 00 00 20 20 20 00 00 20 20 20 00 00 00 00 00 00
00 00 00 00 00 00 00 20 20 20 20 20 20 20 00 00 00 00 00 00
00 00 00 00 00 00 00 20 20 20 20 20 00 00 00 00 00 00 00 00
00 00 00 00 00 00 00 00 00 20 20 00 00 00 00 00 00 00 00 00
00 00 00 00 00 00 00 00 00 00 00 00 00 00 00 00 00 00 00 00
00 00 00 00 00 00 00 00 00 00 00 00 00 00 00 00 00 00 00 00
00 00 00 00 00 00 00 00 00 00 00 00 00 00 00 00 00 00 00 00
00 00 00 00 00 00 00 00 10 60 60 10 00 00 00 00 00 00 00 00
00 00 00 00 00 00 00 00 10 10 10 10 00 00 00 00 00 00 00 00