20 20 Woodland Medium
00 00 00 00 00 00 00 00 10 10 10 10 00 00 00 00 00 00 00 00
00 00 00 00 00 00 00 00 10 60 60 10 00 00 00 00 00 00 00 00
00 00 00 00 00 00 00 00 00 00 00 00 00 00 00 00 00 00 00 00
00 00 00 00 00 00 00 00 00 00 00 00 00 00 00 00 00 00 00 00
00 00 00 00 00 00 00 00 00 00 00 00 00 00 00 00 00 00 00 00
00 00 00 00 00 00 00 00 20 20 20 20 00 00 00 00 00 00 00 00
00 00 00 00 00 00 00 20 20 20 20 20 20 00 00 00 00 00 00 00
00 00 00 00 00 00 20 20 20 20 20 20 20 20 00 00 00 00 00 00
10 10 00 00 00 20 20 20 20 50 50 20 20 20 20 00 00 00 10 10
10 60 00 00 00 20 20 20 50 20 20 50 20 20 20 00 00 00 60 10
10 60 00 00 00 20 20 20 50 20 20 50 20 20 20 00 00 00 60 10
10 10 00 00 00 20 20 20 20 50 50 20 20 20 20 00 00 00 10 10
00 00 00 00 00 00 20 20 20 20 20 20 20 20 00 00 00 00 00 00
00 00 00 00 00 00 00 20 20 20 20 20 20 00 00 00 00 00 00 00
00 00 00 00 00 00 00 00 20 20 20 20 00 00 00 00 00 00 00 00
00 00 00 00 00 00 00 00 00 00 00 00 00 00 00 00 00 00 00 00
00 00 00 00 00 00 00 00 00 00 00 00 00 00 00 00 00 00 00 00
00 00 00 00 00 00 00 00 00 00 00 00 00 00 00 00 00 00 00 00
00 00 00 00 00 00 00 00 10 60 60 10 00 00 00 00 00 00 00 00
00 00 00 00 00 00 00 00 10 10 10 10 00 00 00 00 00 00 00 00