13 15 woodland small
00 00 00 00 00 00 00 00 00 00 00 00 00
00 00 00 40 00 10 60 60 60 00 00 00 00
00 00 10 00 00 00 60 60 60 00 00 00 00
00 00 00 00 00 00 40 00 20 00 00 00 00
00 00 20 20 20 00 00 00 20 20 00 00 00
10 10 20 20 20 20 00 00 00 00 00 00 00
00 00 20 20 20 20 00 00 10 10 00 00 00
00 00 00 00 00 00 00 10 00 00 00 00 00
00 00 10 10 00 00 00 00 00 00 00 00 00
00 00 00 10 00 00 00 20 00 20 00 00 00
00 00 00 00 00 10 00 20 00 20 00 00 00
00 00 00 00 00 00 00 00 00 20 00 00 00
00 50 50 50 00 00 00 00 00 00 00 00 00
00 50 50 50 00 00 10 00 00 10 00 00 00
00 00 20 20 00 00 00 00 00 00 00 00 00